#domain
hospital
#levelname
BFSfriendly_prof_style
#colors
blue: 0,1,2,3,4
#initial
+++++++++++++++++++++++++++++++++++++
+                 0                 +
+++++++++++++++++++++++++++++++++++++
+                 1                 +
+++++++++++++++++++++++++++++++++++++
+                 2                 +
+++++++++++++++++++++++++++++++++++++
+                 3                 +
+++++++++++++++++++++++++++++++++++++
+                 4                 +
+++++++++++++++++++++++++++++++++++++
#goal
+++++++++++++++++++++++++++++++++++++
+                0                  +
+++++++++++++++++++++++++++++++++++++
+                 1                 +
+++++++++++++++++++++++++++++++++++++
+                 2                 +
+++++++++++++++++++++++++++++++++++++
+                 3                 +
+++++++++++++++++++++++++++++++++++++
+                 4                 +
+++++++++++++++++++++++++++++++++++++
#end