#domain
hospital
#levelname
BFSfriendly
#colors
blue: 0,1,2,3,4,5,6,7,8
#initial
++++++++++++++++++++++
+         +1234567   +
+         +          +
+         +          +
+       0 +          +
++++++++++++++++++++++
#goal
++++++++++++++++++++++
+         +          +
+         +          +
+         +          +
+        0+          +
++++++++++++++++++++++
#end