#domain
hospital
#levelname
MAPF03
#colors
blue: 0,1
#initial
+++++++++++++
+0          +
+        ++++
+           +
+        ++ +
+1        + +
+++++++++++++
#goal
+++++++++++++
+           +
+        ++++
+           +
+        ++ +
+1        +0+
+++++++++++++
#end
