#domain
hospital
#levelname
Tittling
#colors
blue: 0, A, K, U
red: 1, B, L, V
cyan: 2, C, M, W
purple: 3, D, N, X
green: 4, E, O, Y
orange: 5, F, P, Z
pink: 6, G, Q
grey: 7, H, R
lightblue: 8, I, S
brown: 9, J, T
#initial
+++++++++++++++++++++++++++++++++++++++++++++++++++++++++++++
+                             +                             +
+ 0                          1+                             +
+  +++++++++++++++++++++ ++   +   +++++++++++ +++++++++++   +
+  + A                 B      +   + K                 L +   +
+  +    +++++++++++++++           +     +   M     +     +   +
+  +   + C              D +       +     +++++ +++++     +   +
+  +   +    +++++++   +   +   +   +     +         +     +   +
+  +   +   + E      F +   +  8+   +     + N     O +     +   +
+  +   +   +      +   +   +   +                             +
+  +   +   +++++ ++   +   +   +   + P   +         +   Q +   +
+  +   + G            + H +   +   +     +   R     +     +   +
+  +   +++++++++++++ ++   +   +   +     +++++ +++++     +   +
+I                    J+   +   +     +         +     +      +
++ +++++++++++++++++++++       + S                 T +      +
+                       +++++   +++++++++++++ +++++++++++   +
+ 2                     +           +                     3 +
+ ++++++++++++++++++++++ +           ++++++++++++++++++++++ +
+ 4                     +    U V    +                     5 +
+   +     +     +     + +++++   +++++      +      +      +  +
+  +++ ++++++ ++++++ ++++++ +     ++++ ++++++ ++++++ +++++  +
+                             +     +      +      +      +  +
+   +   W +     +     + X   + +                             +
+  +++ ++++++ ++++++ ++++++ + +     +      +      +      +  +
+   +     +     +     +     + +   ++++ ++++++ ++++++ +++++  +
+ Y                          Z+     +      +      +      +  +
+  +++ ++++++ ++++++ ++++++ + +                             +
+   +     +     +     +     + +     +      +      +      +  +
+   +     +     +     +     + +   ++++ ++++++ ++++++ +++++  +
+  +++ ++++++ ++++++ ++++++ +       +      +      +      +  +
+                             9                             +
+   +     +     +     +     + +     +      +      +      +  +
+  +++ ++++++ ++++++ ++++++ + +   ++++ ++++++ ++++++ +++++  +
+ 6                           +                           7 +
+++++++++++++++++++++++++++++++++++++++++++++++++++++++++++++
#goal
+++++++++++++++++++++++++++++++++++++++++++++++++++++++++++++
+                             +                             +
+ 7                           +                           6 +
+  +++++++++++++++++++++ ++   +   +++++++++++ +++++++++++   +
+  + T                 S      +   + J                 I +   +
+  +    +++++++++++++++           +     +   H     +     +   +
+  +   + R              Q +       +     +++++ +++++     +   +
+  +   +    +++++++   +   +   +   +     +         +     +   +
+  +   +   + P      O +   +  9+   +     + G     F +     +   +
+  +   +   +      +   +   +   +                             +
+  +   +   +++++ ++   +   +   +   + E   +         +   D +   +
+  +   + N            + M +   +   +     +   C     +     +   +
+  +   +++++++++++++ ++   +   +   +     +++++ +++++     +   +
+L                    K+   +   +     +         +     +      +
++ +++++++++++++++++++++       + B                 A +      +
+                       +++++   +++++++++++++ +++++++++++   +
+ 5                     +           +                     4 +
+ ++++++++++++++++++++++ +           ++++++++++++++++++++++ +
+ 3                     +   Y   Z   +                     2 +
+   +     +     +     + +++++   +++++      +      +      +  +
+  +++ ++++++ ++++++ ++++++ +     ++++ ++++++ ++++++ +++++  +
+                             +     +      +      +      +  +
+   +   X +     +     + W   + +                             +
+  +++ ++++++ ++++++ ++++++ + +     +      +      +      +  +
+   +     +     +     +     + +   ++++ ++++++ ++++++ +++++  +
+ V                          U+     +      +      +      +  +
+  +++ ++++++ ++++++ ++++++ + +                             +
+   +     +     +     +     + +     +      +      +      +  +
+   +     +     +     +     + +   ++++ ++++++ ++++++ +++++  +
+  +++ ++++++ ++++++ ++++++ +       +      +      +      +  +
+                             8                             +
+   +     +     +     +     + +     +      +      +      +  +
+  +++ ++++++ ++++++ ++++++ + +   ++++ ++++++ ++++++ +++++  +
+ 1                           +                           0 +
+++++++++++++++++++++++++++++++++++++++++++++++++++++++++++++
#end
