#domain
hospital
#levelname
TeamAgent
#colors
red: 0, A
green: 1, B
blue: 2, C
#initial
+++++++++++++++
+         0  2+
+ +++++++++A  +
+ +   +   +CB +
+ + + + + +  1+
+ + + + + +   +
+ + + + + +   +
+   +   +     +
+++++++++++++++
#goal
+++++++++++++++
+B1           +
+ +++++++++   +
+ +   + C +   +
+ + + + + +   +
+ + + +2+ +   +
+ + + + + +   +
+   +   +   0A+
+++++++++++++++
#end